############
#@.........#
##########.#
#.#......#.#
#.######.#.#
#.........X#
############
