████████████
█@.........█
██████████.█
█.█........█
█.█████.████
█.........X█
████████████