###########################
#...@.......#.............#
#.#..########.............#
#.#######.#...............#
#.#.......#...............#
#.#.....#.#.##########.####
#.#.....#.#.#........#....#
#.#.....#.#.#....#...#....#
#.#####.###.#....#.X.####.#
#.#.........#.####.###....#
#.#.#########.##...#.#..###
#.#.######.........#.#....#
#.#.#.####......####.####.#
#.#.#.####..########...#..#
#...#................#....#
###########################